w w w w w w w w w w
w w w w w w w w w w
w w w w w w w w w w
w w w e e p e e w w
w w w b e w w w w w
w w w e w w w w w w
w w w s w w w w w w
w w w w w w w w w w
w w w w w w w w w w
w w w w w w w w w w